EXT1	Eu sou do tipo "a vida é uma festa".
EXT2	Eu não falo muito.
EXT3	Sinto-me confortável perto das pessoas.
EXT4	Eu me mantenho em segundo plano.
EXT5	Eu inicio conversas.
EXT6	Costumo ter pouco a dizer.
EXT7	Converso com muitas pessoas diferentes em festas.
EXT8	Não gosto de chamar atenção para mim.
EXT9	Não me importo de ser o centro das atenções.
EXT10	Fico quieto perto de estranhos.
EST1	Fico estressado facilmente.
EST2	Estou relaxado a maior parte do tempo.
EST3	Eu me preocupo com as coisas.
EST4	Raramente me sinto triste.
EST5	Sou facilmente perturbado.
EST6	Eu fico chateado facilmente.
EST7	Mudo muito meu humor.
EST8	Tenho alterações de humor frequentes.
EST9	Eu fico irritado facilmente.
EST10	Muitas vezes me sinto triste.
AGR1	Sinto pouca preocupação pelos outros.
AGR2	Interesso-me por pessoas.
AGR3	Eu insulto as pessoas.
AGR4	Simpatizo com os sentimentos dos outros.
AGR5 	Não estou interessado nos problemas dos outros.
AGR6	Eu tenho um coração mole.
AGR7	Não estou realmente interessado nos outros.
AGR8	Reservo tempo para os outros.
AGR9	Sinto as emoções dos outros.
AGR10	Deixo as pessoas à vontade.
CSN1	Estou sempre preparado.
CSN2	Deixo meus pertences por aí.
CSN3	Presto atenção aos detalhes.
CSN4	Faço muita bagunça.
CSN5	Eu faço as tarefas na hora.
CSN6	Muitas vezes esqueço de colocar as coisas em seus devidos lugares.
CSN7	Gosto de ordem.
CSN8	Fujo dos meus deveres.
CSN9	Eu sigo um cronograma.
CSN10	Sou exigente no meu trabalho.
OPN1	Tenho um vocabulário rico.
OPN2	Tenho dificuldade em entender ideias abstratas.
OPN3	Tenho uma imaginação fértil.
OPN4	Não estou interessado em ideias abstratas.
OPN5	Tenho excelentes ideias.
OPN6	Não tenho boa imaginação.
OPN7	Sou rápido para entender as coisas.
OPN8	Eu uso palavras difíceis.
OPN9	Passo tempo refletindo sobre as coisas.
OPN10	Estou cheio de ideias.